8
敎	가르칠 교
校	학교 교
九	아홉 구
國	나라 국
軍	군사 군
金	쇠 금
金	성 김
南	남녘 남
女	계집 녀
年	해 년
大	큰 대
東	동녘 동
六	여섯 륙
萬	일만 만
母	어미 모
木	나무 목
門	문 문
民	백성 민
白	흰 백
父	아비 부
北	북녘 북
北	달아날 배
四	넉 사
山	메 산
三	석 삼
生	날 생
西	서녘 서
先	먼저 선
小	작을 소
水	물 수
室	집 실
十	열 십
五	다섯 오
王	임금 왕
外	바깥 외
月	달 월
二	두 이
人	사람 인
一	한 일
日	날 일
長	긴 장
弟	아우 제
中	가운데 중
靑	푸를 청
寸	마디 촌
七	일곱 칠
土	흙 토
八	여덟 팔
學	배울 학
韓	한국 한
兄	형 형
火	불 화
7
家	집 가
歌	노래 가
間	사이 간
江	강 강
車	수레 거
車	수레 차
工	장인 공
空	빌 공
口	입 구
旗	기 기
氣	기운 기
記	기록할 기
男	사내 남
內	안 내
農	농사 농
答	대답 답
道	길 도
冬	겨울 동
動	움직일 동
同	한가지 동
洞	골 동
洞	밝을 통
登	오를 등
來	올 래
力	힘 력
老	늙을 로
里	마을 리
林	수풀 림
立	설 립
每	매양 매
面	낯 면
名	이름 명
命	목숨 명
問	물을 문
文	글월 문
物	물건 물
方	모 방
百	일백 백
不	아닐 불
不	아닐 부
夫	지아비 부
事	일 사
算	셈 산
上	윗 상
色	빛 색
夕	저녁 석
姓	성 성
世	인간 세
少	적을 소
所	바 소
手	손 수
數	셈 수
數	자수 삭
數	촘촘할 촉
市	저자 시
時	때 시
植	심을 식
食	밥 식
食	먹일 사
心	마음 심
安	편안 안
語	말씀 어
然	그럴 연
午	낮 오
右	오른 우
有	있을 유
育	기를 육
邑	고을 읍
入	들 입
子	아들 자
字	글자 자
自	스스로 자
場	마당 장
全	온전 전
前	앞 전
電	번개 전
正	바를 정
祖	할아비 조
足	발 족
左	왼 좌
主	주인 주
住	살 주
重	무거울 중
地	따 지
紙	종이 지
直	곧을 직
千	일천 천
天	하늘 천
川	내 천
草	풀 초
村	마을 촌
秋	가을 추
春	봄 춘
出	날 출
便	편할 편
便	똥오줌 변
平	평평할 평
下	아래 하
夏	여름 하
漢	한나라 한
海	바다 해
花	꽃 화
話	말씀 화
活	살 활
活	물소리 괄
孝	효도 효
後	뒤 후
休	쉴 휴
6
各	각각 각
角	뿔 각
感	느낄 감
强	강할 강
開	열 개
京	서울 경
界	지경 계
計	셀 계
古	예 고
苦	쓸 고
高	높을 고
公	공평할 공
共	한가지 공
功	공 공
果	실과 과
科	과목 과
光	빛 광
交	사귈 교
區	구분할 구
球	공 구
郡	고을 군
根	뿌리 근
近	가까울 근
今	이제 금
急	급할 급
級	등급 급
多	많을 다
短	짧을 단
堂	집 당
代	대신 대
對	대할 대
待	기다릴 대
圖	그림 도
度	법도 도
度	헤아릴 탁
讀	읽을 독
讀	구절 두
童	아이 동
頭	머리 두
等	무리 등
樂	즐길 락
樂	노래 악
樂	좋아할 요
例	법식 례
禮	예도 례
路	길 로
綠	푸를 록
利	이로울 리
李	오얏 리
李	성 리
理	다스릴 리
明	밝을 명
目	눈 목
聞	들을 문
米	쌀 미
美	아름다울 미
朴	성 박
半	반 반
反	돌이킬 반
反	돌아올 반
班	나눌 반
發	필 발
放	놓을 방
番	차례 번
別	나눌 별
別	다를 별
病	병 병
服	옷 복
本	근본 본
部	떼 부
分	나눌 분
使	부릴 사
使	하여금 사
死	죽을 사
社	모일 사
書	글 서
席	자리 석
石	돌 석
線	줄 선
雪	눈 설
成	이룰 성
省	살필 성
省	덜 생
消	사라질 소
速	빠를 속
孫	손자 손
樹	나무 수
術	재주 술
習	익힐 습
勝	이길 승
始	비로소 시
式	법 식
信	믿을 신
新	새 신
神	귀신 신
身	몸 신
失	잃을 실
愛	사랑 애
夜	밤 야
野	들 야
弱	약할 약
藥	약 약
洋	큰바다 양
陽	볕 양
言	말씀 언
業	업 업
永	길 영
英	꽃부리 영
溫	따뜻할 온
勇	날랠 용
用	쓸 용
運	옮길 운
園	동산 원
遠	멀 원
油	기름 유
由	말미암을 유
銀	은 은
音	소리 음
飮	마실 음
意	뜻 의
衣	옷 의
醫	의원 의
者	놈 자
作	지을 작
昨	어제 작
章	글 장
在	있을 재
才	재주 재
戰	싸움 전
定	정할 정
庭	뜰 정
第	차례 제
題	제목 제
朝	아침 조
族	겨레 족
晝	낮 주
注	부을 주
集	모을 집
窓	창 창
淸	맑을 청
體	몸 체
親	친할 친
太	클 태
通	통할 통
特	특별할 특
表	겉 표
風	바람 풍
合	합할 합
合	홉 홉
幸	다행 행
行	다닐 행
行	항렬 항
向	향할 향
現	나타날 현
形	모양 형
號	이름 호
和	화할 화
畵	그림 화
畵	그을 획
黃	누를 황
會	모일 회
訓	가르칠 훈
5
價	값 가
加	더할 가
可	옳을 가
改	고칠 개
客	손 객
去	갈 거
擧	들 거
件	물건 건
健	굳셀 건
建	세울 건
格	격식 격
見	볼 견
見	뵈올 현
決	결단할 결
結	맺을 결
敬	공경 경
景	볕 경
競	다툴 경
輕	가벼울 경
告	고할 고
告	청할 곡
固	굳을 고
考	생각할 고
曲	굽을 곡
課	과정 과
過	지날 과
觀	볼 관
關	관계할 관
廣	넓을 광
橋	다리 교
具	갖출 구
救	구원할 구
舊	예 구
局	판 국
貴	귀할 귀
規	법 규
給	줄 급
基	터 기
己	몸 기
技	재주 기
期	기약할 기
汽	물끓는김 기
吉	길할 길
念	생각 념
能	능할 능
團	둥글 단
壇	단 단
談	말씀 담
當	마땅 당
德	큰 덕
到	이를 도
島	섬 도
都	도읍 도
獨	홀로 독
落	떨어질 락
朗	밝을 랑
冷	찰 랭
良	어질 량
量	헤아릴 량
旅	나그네 려
歷	지날 력
練	익힐 련
令	하여금 령
領	거느릴 령
勞	일할 로
料	헤아릴 료
流	흐를 류
類	무리 류
陸	뭍 륙
馬	말 마
末	끝 말
亡	망할 망
望	바랄 망
買	살 매
賣	팔 매
無	없을 무
倍	곱 배
法	법 법
變	변할 변
兵	병사 병
福	복 복
奉	받들 봉
比	견줄 비
費	쓸 비
鼻	코 비
氷	얼음 빙
仕	섬길 사
史	사기 사
士	선비 사
寫	베낄 사
思	생각 사
査	조사할 사
産	낳을 산
商	장사 상
相	서로 상
賞	상줄 상
序	차례 서
仙	신선 선
善	착할 선
船	배 선
選	가릴 선
鮮	고울 선
說	말씀 설
說	달랠 세
說	기쁠 열
性	성품 성
歲	해 세
洗	씻을 세
束	묶을 속
首	머리 수
宿	잘 숙
宿	별자리 수
順	순할 순
示	보일 시
識	알 식
識	기록할 지
臣	신하 신
實	열매 실
兒	아이 아
惡	악할 악
惡	미워할 오
案	책상 안
約	맺을 약
養	기를 양
漁	고기잡을 어
魚	고기 어
億	억 억
熱	더울 열
葉	입 엽
屋	집 옥
完	완전할 완
曜	빛날 요
要	요긴할 요
浴	목욕할 욕
友	벗 우
牛	소 우
雨	비 우
雲	구름 운
雄	수컷 웅
元	으뜸 원
原	언덕 원
院	집 원
願	원할 원
位	자리 위
偉	클 위
以	써 이
耳	귀 이
因	인할 인
任	맡길 임
再	두 재
材	재목 재
災	재앙 재
財	재물 재
爭	다툴 쟁
貯	쌓을 저
的	과녁 적
赤	붉을 적
傳	전할 전
典	법 전
展	펼 전
切	끊을 절
切	온통 체
節	마디 절
店	가게 점
停	머무를 정
情	뜻 정
操	잡을 조
調	고를 조
卒	마칠 졸
種	씨 종
終	마칠 종
罪	허물 죄
州	고을 주
週	주일 주
止	그칠 지
知	알 지
質	바탕 질
着	붙을 착
參	참여할 참
參	석 삼
唱	부를 창
責	꾸짖을 책
鐵	쇠 철
初	처음 초
最	가장 최
祝	빌 축
充	채울 충
致	이를 치
則	법칙 칙
則	곧 즉
他	다를 타
打	칠 타
卓	높을 탁
炭	숯 탄
宅	집 택 / 집 댁
板	널 판
敗	패할 패
品	물건 품
必	반드시 필
筆	붓 필
河	물 하
寒	찰 한
害	해할 해
許	허락 허
湖	호수 호
化	될 화
患	근심 환
效	본받을 효
凶	흉할 흉
黑	검을 흑
준4
假	거짓 가
街	거리 가
減	덜 감
監	볼 감
康	편안 강
講	욀 강
個	낱 개
檢	검사할 검
潔	깨끗할 결
缺	이지러질 결
境	지경 경
慶	경사 경
經	글 경
經	지날 경
警	깨우칠 경
係	맬 계
故	연고 고
攻	칠 공
官	벼슬 관
句	글귀 구
求	구할 구
究	연구할 구
宮	집 궁
權	권세 권
極	다할 극
禁	금할 금
器	그릇 기
起	일어날 기
暖	따뜻할 난
難	어려울 난
努	힘쓸 노
怒	성낼 노
單	홑 단
單	흉노임금 선
斷	끊을 단
檀	박달나무 단
端	끝 단
達	통달할 달
擔	멜 담
黨	무리 당
帶	띠 대
隊	무리 대
導	인도할 도
毒	독 독
督	감독할 독
銅	구리 동
斗	말 두
豆	콩 두
得	얻을 득
燈	등 등
羅	벌릴 라
兩	두 량
麗	고울 려
連	이을 련
列	벌일 렬
錄	기록할 록
論	논할 론
留	머무를 류
律	법칙 률
滿	찰 만
脈	줄기 맥
毛	털 모
牧	칠 목
務	힘쓸 무
武	호반 무
味	맛 미
未	아닐 미
密	빽빽할 밀
博	넓을 박
房	방 방
訪	찾을 방
防	막을 방
拜	절 배
背	등 배
配	짝 배
伐	칠 벌
罰	벌할 벌
壁	벽 벽
邊	가 변
保	지킬 보
報	갚을 보
報	알릴 보
寶	보배 보
步	걸음 보
副	버금 부
婦	며느리 부
富	부자 부
府	관청 부
復	다시 부
復	회복할 복
佛	부처 불
備	갖출 비
悲	슬플 비
非	아닐 비
飛	날 비
貧	가난할 빈
寺	절 사
寺	내시 시
師	스승 사
舍	집 사
謝	사례할 사
殺	감할 쇄
殺	죽일 살
常	떳떳할 상
床	상 상
想	생각 상
狀	문서 장
狀	형상 상
設	베풀 설
城	재 성
星	별 성
盛	성할 성
聖	성인 성
聲	소리 성
誠	정성 성
勢	형세 세
稅	세금 세
細	가늘 세
掃	쓸 소
笑	웃음 소
素	본디 소
俗	풍속 속
續	이을 속
送	보낼 송
修	닦을 수
受	받을 수
守	지킬 수
授	줄 수
收	거둘 수
純	순수할 순
承	이을 승
施	베풀 시
是	이 시
視	볼 시
試	시험 시
詩	시 시
息	쉴 식
申	납 신
深	깊을 심
眼	눈 안
暗	어두울 암
壓	누를 압
液	진 액
羊	양 양
如	같을 여
餘	남을 여
逆	거스릴 역
演	펼 연
煙	연기 연
硏	갈 연
榮	영화 영
藝	재주 예
誤	그르칠 오
玉	구슬 옥
往	갈 왕
謠	노래 요
容	얼굴 용
員	인원 원
圓	둥글 원
爲	할 위
衛	지킬 위
肉	고기 육
恩	은혜 은
陰	그늘 음
應	응할 응
義	옳을 의
議	의논할 의
移	옮길 이
益	더할 익
印	도장 인
引	끌 인
認	알 인
將	장수 장
障	막을 장
低	낮을 저
敵	대적할 적
田	밭 전
絶	끊을 절
接	이을 접
政	정사 정
程	길 정
精	정할 정
制	절제할 제
提	끌 제
濟	건널 제
祭	제사 제
製	지을 제
除	덜 제
際	즈음 제
助	도울 조
早	이를 조
造	지을 조
鳥	새 조
尊	높을 존
宗	마루 종
走	달릴 주
竹	대 죽
準	준할 준
衆	무리 중
增	더할 증
志	뜻 지
指	가리킬 지
支	지탱할 지
至	이를 지
職	직분 직
眞	참 진
進	나아갈 진
次	버금 차
讚	기릴 찬
察	살필 찰
創	비롯할 창
處	곳 처
請	청할 청
總	다 총
銃	총 총
築	쌓을 축
蓄	모을 축
忠	충성 충
蟲	벌레 충
取	가질 취
測	헤아릴 측
治	다스릴 치
置	둘 치
齒	이 치
侵	침노할 침
快	쾌할 쾌
態	모습 태
統	거느릴 통
退	물러날 퇴
波	물결 파
破	깨뜨릴 파
包	쌀 포
布	베 포
布	펼 포
布	보시 보
砲	대포 포
暴	사나울 폭
暴	모질 포
票	표 표
豊	풍년 풍
限	한할 한
港	항구 항
航	배 항
解	풀 해
鄕	시골 향
香	향기 향
虛	빌 허
驗	시험할 험
賢	어질 현
血	피 혈
協	화할 협
惠	은혜 혜
呼	부를 호
戶	집 호
護	도울 호
貨	재물 화
確	굳을 확
回	돌아올 회
興	일 흥
希	바랄 희
4
暇	틈 가
刻	새길 각
覺	깨달을 각
干	방패 간
看	볼 간
簡	간략할 간
簡	대쪽 간
敢	감히 감
甘	달 감
甲	갑옷 갑
降	내릴 강
降	항복할 항
更	고칠 경
更	다시 갱
居	살 거
巨	클 거
拒	막을 거
據	근거 거
傑	뛰어날 걸
儉	검소할 검
擊	칠 격
激	격할 격
堅	굳을 견
犬	개 견
傾	기울 경
鏡	거울 경
驚	놀랄 경
季	계절 계
戒	경계할 계
系	이어맬 계
繼	이을 계
階	섬돌 계
鷄	닭 계
孤	외로울 고
庫	곳집 고
穀	곡식 곡
困	곤할 곤
骨	뼈 골
孔	구멍 공
管	대롱 관
管	주관할 관
鑛	쇳돌 광
構	얽을 구
君	임금 군
群	무리 군
屈	굽힐 굴
窮	다할 궁
窮	궁할 궁
券	문서 권
勸	권할 권
卷	책 권
歸	돌아갈 귀
均	고를 균
劇	심할 극
勤	부지런할 근
筋	힘줄 근
奇	기특할 기
寄	부칠 기
機	틀 기
紀	벼리 기
納	들일 납
段	층계 단
徒	무리 도
盜	도둑 도
逃	도망할 도
亂	어지러울 란
卵	알 란
覽	볼 람
略	간략할 략
糧	양식 량
慮	생각할 려
烈	매울 렬
龍	용 룡
柳	버들 류
輪	바퀴 륜
離	떠날 리
妹	누이 매
勉	힘쓸 면
鳴	울 명
模	본뜰 모
墓	무덤 묘
妙	묘할 묘
舞	춤출 무
拍	칠 박
髮	터럭 발
妨	방해할 방
犯	범할 범
範	법 범
辯	말씀 변
普	넓을 보
伏	엎드릴 복
複	겹칠 복
否	아닐 부
否	막힐 비
負	질 부
憤	분할 분
粉	가루 분
批	비평할 비
碑	비석 비
秘	숨길 비
射	쏠 사
私	사사 사
絲	실 사
辭	말씀 사
散	흩을 산
傷	다칠 상
象	코끼리 상
宣	베풀 선
舌	혀 설
屬	붙일 속
損	덜 손
松	소나무 송
頌	칭송할 송
秀	빼어날 수
叔	아재비 숙
肅	엄숙할 숙
崇	높을 숭
氏	성 씨
額	이마 액
樣	모양 양
嚴	엄할 엄
與	더불 여
與	줄 여
域	지경 역
易	바꿀 역
易	쉬울 이
延	늘일 연
燃	탈 연
緣	인연 연
鉛	납 연
映	비칠 영
營	경영할 영
迎	맞을 영
豫	미리 예
優	넉넉할 우
遇	만날 우
郵	우편 우
怨	원망할 원
援	도울 원
源	근원 원
危	위태할 위
圍	에워살 위
委	맡길 위
威	위엄 위
慰	위로할 위
乳	젖 유
儒	선비 유
遊	놀 유
遺	남길 유
隱	숨을 은
依	의지할 의
儀	거동 의
疑	의심할 의
異	다를 이
仁	어질 인
姉	손위누이 자
姿	모양 자
資	재물 자
殘	남을 잔
雜	섞일 잡
壯	장할 장
奬	장려할 장
帳	장막 장
張	베풀 장
腸	창자 장
裝	꾸밀 장
底	밑 저
積	쌓을 적
籍	문서 적
績	길쌈 적
賊	도둑 적
適	맞을 적
專	오로지 전
轉	구를 전
錢	돈 전
折	꺽을 절
占	점칠/점령할 점
點	점 점
丁	고무래 정
整	가지런할 정
靜	고요할 정
帝	임금 제
條	가지 조
潮	조수 조
組	짤 조
存	있을 존
從	좇을 종
鐘	쇠북 종
座	자리 좌
周	두루 주
朱	붉을 주
酒	술 주
證	증거 증
持	가질 지
智	지혜 지
誌	기록할 지
織	짤 직
珍	보배 진
盡	다할 진
陣	진칠 진
差	다를 차
差	어긋날 치
採	캘 채
冊	책 책
泉	샘 천
廳	관청 청
聽	들을 청
招	부를 초
推	밀 추
推	밀 퇴
縮	줄일 축
就	나아갈 취
趣	뜻 취
層	층 층
寢	잘 침
針	바늘 침
稱	일컬을 칭
彈	탄알 탄
歎	탄식할 탄
脫	벗을 탈
探	찾을 탐
擇	가릴 택
討	칠 토
痛	아플 통
投	던질 투
鬪	싸움 투
派	갈래 파
判	판단할 판
篇	책 편
評	평할 평
閉	닫을 폐
胞	세포 포
爆	불터질 폭
標	표할 표
疲	피곤할 피
避	피할 피
恨	한 한
閑	한가할 한
抗	겨룰 항
核	씨 핵
憲	법 헌
險	험할 험
革	가죽 혁
顯	나타날 현
刑	형벌 형
好	좋을 호
或	혹 혹
婚	혼인할 혼
混	섞을 혼
紅	붉을 홍
華	빛날 화
歡	기쁠 환
環	고리 환
況	상황 황
灰	재 회
候	기후 후
厚	두터울 후
揮	휘두를 휘
吸	마실 흡
喜	기쁠 희
준3
佳	아름다울 가
脚	다리 각
閣	집 각
刊	새길 간
幹	줄기 간
懇	간절할 간
肝	간 간
鑑	거울 감
剛	굳셀 강
綱	벼리 강
介	낄 개
槪	대개 개
距	상거할 거
乾	하늘 건
乾	마를 간
劍	칼 검
兼	겸할 겸
謙	겸손할 겸
耕	밭갈 경
頃	이랑 경
頃	잠깐 경
啓	열 계
契	맺을 계
械	기계 계
溪	시내 계
姑	시어미 고
稿	볏집 고
稿	원고 고
鼓	북 고
哭	울 곡
谷	골 곡
供	이바지할 공
恐	두려울 공
恭	공손할 공
貢	바칠 공
寡	적을 과
誇	자랑할 과
冠	갓 관
寬	너그러울 관
慣	익숙할 관
貫	꿸 관
館	집 관
壞	무너질 괴
怪	괴이할 괴
巧	공교할 교
較	비교 교
久	오랠 구
拘	잡을 구
菊	국화 국
弓	활 궁
拳	주먹 권
鬼	귀신 귀
克	이길 극
琴	거문고 금
禽	새 금
錦	비단 금
及	미칠 급
企	꾀할 기
其	그 기
畿	경기 기
祈	빌 기
緊	긴할 긴
諾	허락할 낙
娘	계집 낭
乃	이에 내
耐	견딜 내
寧	편안 녕
奴	종 노
腦	골 뇌
茶	차 다
茶	차 차
丹	붉을 단
但	다만 단
旦	아침 단
淡	맑을 담
踏	밟을 답
唐	당나라 당
臺	대 대
刀	칼 도
途	길 도
陶	질그릇 도
突	갑자기 돌
絡	이을 락
欄	난간 란
蘭	난초 란
廊	사랑채 랑
浪	물결 랑
郞	사내 랑
凉	서늘할 량
勵	힘쓸 려
曆	책력 력
戀	그리워할 련
聯	연이을 련
鍊	단련할 련
鍊	쇠불릴 련
嶺	고개 령
靈	신령 령
爐	화로 로
露	이슬 로
弄	희롱할 롱
賴	의뢰할 뢰
樓	다락 루
倫	인륜 륜
栗	밤 률
率	비율 률
率	거느릴 솔
隆	높을 륭
陵	언덕 릉
吏	관리 리
履	밟을 리
裏	속 리
臨	임할 림
幕	장막 막
漠	넓을 막
莫	없을 막
妄	망녕될 망
梅	매화 매
孟	맏 맹
猛	사나울 맹
盲	소경 맹
盟	맹세 맹
眠	잘 면
綿	솜 면
滅	멸할 멸
銘	새길 명
慕	그릴 모
謀	꾀 모
貌	모양 모
睦	화목할 목
沒	빠질 몰
夢	꿈 몽
蒙	어두울 몽
茂	무성할 무
貿	무역할 무
默	잠잠할 묵
勿	말 물
微	작을 미
薄	엷을 박
迫	핍박할 박
飯	밥 반
培	북돋울 배
排	밀칠 배
輩	무리 배
伯	맏 백
繁	번성할 번
凡	무릇 범
碧	푸를 벽
丙	남녘 병
補	기울 보
腹	배 복
封	봉할 봉
峯	봉오리 봉
逢	만날 봉
付	부칠 부
扶	도울 부
浮	뜰 부
符	부호 부
簿	문서 부
附	붙을 부
奔	달릴 분
奮	떨칠 분
紛	어지러울 분
卑	낮을 비
妃	왕비 비
婢	계집종 비
肥	살찔 비
司	맡을 사
沙	모래 사
祀	제사 사
詞	말 사
邪	간사할 사
森	수풀 삼
像	모양 상
喪	잃을 상
尙	오히려 상
裳	치마 상
詳	자세할 상
霜	서리 상
索	찾을 색
索	노 삭
徐	천천할 서
恕	용서할 서
緖	실마리 서
署	관청 서
惜	아낄 석
釋	풀 석
旋	돌 선
疎	드물 소
蘇	되살아날 소
訴	호소할 소
刷	인쇄할 쇄
衰	쇠할 쇠
壽	목숨 수
帥	장수 수
愁	근심 수
殊	다를 수
獸	짐승 수
輸	보낼 수
隨	따를 수
需	쓰일 수
淑	맑을 숙
熟	익을 숙
巡	순행할 순
旬	열흘 순
瞬	눈깜짝일 순
述	펼 술
拾	주울 습
拾	열 십
襲	엄습할 습
乘	탈 승
僧	중 승
昇	오를 승
侍	모실 시
飾	꾸밀 식
愼	삼갈 신
審	살필 심
甚	심할 심
雙	두 쌍
亞	버금 아
我	나 아
阿	언덕 아
雅	맑을 아
岸	언덕 안
顔	낯 안
岩	바위 암
仰	우러를 앙
央	가운데 앙
哀	슬플 애
若	같을 약
若	반야 야
壤	흙덩이 양
揚	날릴 양
讓	사양할 양
御	거느릴 어
憶	생각할 억
抑	누를 억
亦	또 역
役	부릴 역
譯	번역할 역
驛	역 역
宴	잔치 연
沿	따를 연
軟	연할 연
悅	기쁠 열
染	물들 염
影	그림자 영
譽	기릴 예
悟	깨달을 오
烏	까마귀 오
獄	옥 옥
慾	욕심 욕
欲	하고자할 욕
辱	욕될 욕
偶	짝 우
宇	집 우
愚	어리석을 우
憂	근심 우
韻	운 운
越	넘을 월
謂	이를 위
幼	어릴 유
幽	그윽할 유
悠	멀 유
柔	부드러울 유
猶	오히려 유
維	벼리 유
裕	넉넉할 유
誘	꾈 유
潤	불을 윤
乙	새 을
已	이미 이
翼	날개 익
忍	참을 인
逸	편안할 일
壬	북방 임
慈	사랑 자
暫	잠깐 잠
潛	잠길 잠
丈	어른 장
掌	손바닥 장
粧	단장할 장
臟	오장 장
莊	씩씩할 장
葬	장사지낼 장
藏	감출 장
栽	심을 재
裁	옷마를 재
載	실을 재
抵	막을 저
著	나타날 저
寂	고요할 적
摘	딸 적
笛	피리 적
跡	발자취 적
蹟	자취 적
漸	점점 점
井	우물 정
亭	정자 정
廷	조정 정
征	칠 정
淨	깨끗할 정
貞	곧을 정
頂	정수리 정
諸	모두 제
齊	가지런할 제
兆	억조 조
照	비칠 조
燥	마를 조
縱	세로 종
坐	앉을 좌
宙	집 주
柱	기둥 주
洲	물가 주
卽	곧 즉
憎	미울 증
曾	일찍 증
症	증세 증
蒸	찔 증
之	갈 지
池	못 지
遲	더딜 지
振	떨칠 진
辰	별 진
辰	때 신
鎭	진압할 진
陳	묵을 진
疾	병 질
秩	차례 질
執	잡을 집
徵	부를 징
徵	음률이름 치
此	이 차
贊	도울 찬
倉	곳집 창
昌	창성할 창
蒼	푸를 창
彩	채색 채
菜	나물 채
策	꾀 책
妻	아내 처
尺	자 척
戚	친척 척
拓	넓힐 척
拓	박을 탁
淺	얕을 천
賤	천할 천
踐	밟을 천
哲	밝을 철
徹	통할 철
礎	주춧돌 초
肖	닮을 초
超	뛰어넘을 초
促	재촉할 촉
觸	닿을 촉
催	재촉할 최
追	쫓을 추
衝	찌를 충
吹	불 취
醉	취할 취
側	곁 측
値	값 치
恥	부끄러울 치
稚	어릴 치
沈	잠길 침
沈	성 심
塔	탑 탑
殆	거의 태
泰	클 태
澤	못 택
兎	토끼 토
版	판목 판
片	조각 편
弊	폐단 폐
肺	허파 폐
浦	개 포
楓	단풍 풍
彼	저 피
皮	가죽 피
皮	가죽 비
被	입을 피
畢	마칠 필
何	어찌 하
賀	하례할 하
鶴	학 학
割	벨 할
含	머금을 함
陷	빠질 함
恒	항상 항
項	항목 항
響	울릴 향
獻	드릴 헌
懸	달 현
玄	검을 현
脅	위협할 협
慧	슬기로울 혜
浩	넓을 호
胡	되 호
虎	범 호
豪	호걸 호
惑	미혹할 혹
魂	넋 혼
忽	갑자기 홀
洪	넓을 홍
禍	재앙 화
換	바꿀 환
還	돌아올 환
皇	임금 황
悔	뉘우칠 회
懷	품을 회
劃	그을 획
獲	얻을 획
橫	가로 횡
戱	놀이 희
稀	드물 희
3
架	시렁 가
却	물리칠 각
姦	간음할 간
渴	목마를 갈
鋼	강철 강
慨	슬퍼할 개
皆	다 개
蓋	덮을 개
憩	쉴 게
絹	비단 견
肩	어깨 견
遣	보낼 견
卿	벼슬 경
庚	별 경
徑	지름길 경
硬	굳을 경
竟	마침내 경
桂	계수나무 계
癸	북방 계
癸	천간 계
枯	마를 고
顧	돌아볼 고
坤	따 곤
戈	창 과
瓜	외 과
郭	둘레 곽
郭	외성 곽
掛	걸 괘
塊	흙덩이 괴
愧	부끄러울 괴
矯	바로잡을 교
郊	들 교
丘	언덕 구
俱	함께 구
懼	두려워할 구
狗	개 구
苟	구차할 구
驅	몰 구
鷗	갈매기 구
龜	거북 귀
龜	땅이름 구
龜	터질 균
厥	그 궐
叫	부르짖을 규
閨	안방 규
菌	버섯 균
僅	겨우 근
斤	근 근
謹	삼갈 근
肯	즐길 긍
幾	몇 기
忌	꺼릴 기
旣	이미 기
棄	버릴 기
欺	속일 기
豈	어찌 기
飢	주릴 기
騎	말탈 기
那	어찌 나
奈	어찌 내
奈	나락 나
濃	짙을 농
惱	번뇌할 뇌
泥	진흙 니
潭	못 담
畓	논 답
糖	사탕 탕
糖	엿 당
貸	빌릴 대
倒	넘어질 도
挑	돋울 도
桃	복숭아 도
渡	건널 도
稻	벼 도
跳	뛸 도
篤	도타울 독
敦	도타울 돈
豚	돼지 돈
凍	얼 동
桐	오동나무 동
鈍	둔할 둔
洛	물이름 락
爛	빛날 란
濫	넘칠 람
藍	쪽 람
掠	노략질할 략
梁	들보 량
諒	살펴알 량
憐	불쌍히여길 련
蓮	연꽃 련
劣	못할 렬
裂	찢어질 렬
廉	청렴할 렴
零	떨어질 령
零	영 령
祿	녹 록
鹿	사슴 록
雷	우레 뢰
了	마칠 료
屢	여러 루
淚	눈물 루
漏	샐 루
累	여러 루
梨	배 리
隣	이웃 린
磨	갈 마
麻	삼 마
慢	거만할 만
晩	늦을 만
漫	흩어질 만
蠻	오랑캐 만
忘	잊을 망
忙	바쁠 망
罔	없을 망
茫	아득할 망
埋	묻을 매
媒	중매 매
麥	보리 맥
免	면할 면
冥	어두울 명
募	모을 모
暮	저물 모
某	아무 모
矛	창 모
沐	머리감을 목
卯	토끼 묘
廟	사당 묘
苗	모 묘
戊	천간 무
霧	안개 무
墨	먹 묵
尾	꼬리 미
眉	눈썹 미
迷	미혹할 미
憫	민망할 민
敏	민첩할 민
蜜	꿀 밀
泊	머무를 박
泊	배댈 박
叛	배반할 반
盤	소반 반
般	일반 반
返	돌이킬 반
拔	뽑을 발
倣	본뜰 방
傍	곁 방
芳	꽃다울 방
邦	나라 방
杯	잔 배
栢	측백 백
煩	번거로울 번
飜	번역할 번
汎	넓을 범
辨	분별할 변
屛	병풍 병
竝	나란히 병
譜	족보 보
卜	점 복
蜂	벌 봉
鳳	새 봉
腐	썩을 부
膚	살갗 부
賦	부세 부
赴	갈 부
墳	무덤 분
弗	말 불
弗	아닐 불
拂	떨칠 불
崩	무너질 붕
朋	벗 붕
賓	손 빈
頻	자주 빈
聘	부를 빙
似	닮을 사
巳	뱀 사
捨	버릴 사
斜	비낄 사
斯	이 사
蛇	긴뱀 사
詐	속일 사
賜	줄 사
削	깍을 삭
朔	초하루 삭
酸	실 산
償	갚을 상
嘗	맛볼 상
桑	뽕나무 상
祥	상서 상
塞	막힐 색
塞	변방 새
庶	여러 서
敍	펼 서
暑	더울 서
昔	예 석
析	쪼갤 석
禪	선 선
涉	건널 섭
召	부를 소
昭	밝을 소
燒	사를 소
蔬	나물 소
騷	떠들 소
粟	조 속
訟	송사할 송
誦	욀 송
鎖	쇠사슬 쇄
囚	가둘 수
睡	졸음 수
誰	누구 수
遂	드디어 수
雖	비록 수
須	모름지기 수
孰	누구 숙
循	돌 순
殉	따라죽을 순
盾	방패 순
脣	입술 순
戌	개 술
濕	젖을 습
升	되 승
矢	화살 시
伸	펼 신
晨	새벽 신
辛	매울 신
尋	찾을 심
牙	어금니 아
芽	싹 아
餓	주릴 아
岳	큰산 악
雁	기러기 안
謁	뵐 알
殃	재앙 앙
涯	물가 애
厄	액 액
也	이끼 야
耶	어조사 야
楊	버들 양
於	어조사 어
於	탄식할 오
焉	어찌 언
予	나 여
余	나 여
汝	너 여
輿	수레 여
疫	전염병 역
燕	제비 연
硯	벼루 연
炎	불꽃 염
鹽	소금 염
泳	헤엄칠 영
詠	읊을 영
銳	날카로울 예
傲	거만할 오
吾	나 오
嗚	슬플 오
娛	즐길 오
梧	오동 오
汚	더러울 오
翁	늙은이 옹
瓦	기와 와
臥	누울 와
緩	느릴 완
曰	가로 왈
畏	두려워할 외
搖	흔들 요
腰	허리 요
遙	멀 요
庸	떳떳할 용
于	어조사 우
又	또 우
尤	더욱 우
羽	깃 우
云	이를 운
僞	거짓 위
緯	씨 위
胃	밥통 위
違	어긋날 위
唯	오직 유
惟	생각할 유
愈	나을 유
酉	닭 유
閏	윤달 윤
吟	읊을 음
淫	음란할 음
泣	울 읍
宜	마땅 의
矣	어조사 의
夷	오랑캐 이
而	말이을 이
貳	두 이
刃	칼날 인
姻	혼인 인
寅	범 인
壹	한 일
賃	품삯 임
刺	찌를 자
刺	찌를 척
恣	방자할 자
玆	이 자
紫	자주빛 자
雌	암컷 자
爵	벼슬 작
酌	술부을 작
蠶	누에 잠
墻	담 장
哉	어조사 재
滴	물방울 적
蝶	나비 접
訂	바로잡을 정
堤	둑 제
弔	조상할 조
租	조세 조
拙	졸할 졸
佐	도울 좌
株	그루 주
舟	배 주
俊	준걸 준
遵	좇을 준
仲	버금 중
贈	줄 증
只	다만 지
枝	가지 지
姪	조카 질
懲	징계할 징
且	또 차
借	빌릴 차
捉	잡을 착
錯	어긋날 착
慘	참혹할 참
慙	부끄러울 참
暢	화창할 창
滄	큰바다 창
債	빚 채
悽	슬퍼할 처
斥	물리칠 척
薦	천거할 천
遷	옮길 천
尖	뾰족할 첨
添	더할 첨
妾	첩 첩
晴	갤 청
替	바꿀 체
抄	뽑을 초
燭	촛불 촉
聰	귀밝을 총
抽	뽑을 추
醜	추할 추
丑	소 축
畜	짐승 축
逐	쫒을 축
臭	냄새 취
漆	옻 칠
枕	베게 침
浸	잠길 침
墮	떨어질 타
妥	온당할 타
托	맡길 탁
濁	흐릴 탁
濯	씻을 탁
琢	다듬을 탁
奪	빼앗을 탈
貪	탐낼 탐
湯	끊을 탕
怠	게으를 태
吐	토할 토
透	사무칠 투
播	뿌릴 파
罷	마칠 파
頗	자못 파
販	팔 판
貝	조개 패
編	엮을 편
遍	두루 편
幣	화폐 폐
廢	폐할 폐
蔽	덮을 폐
抱	안을 포
捕	잡을 포
飽	배부를 포
幅	폭 폭
漂	떠다닐 표
匹	짝 필
荷	멜 하
旱	가물 한
汗	땀 한
咸	다 함
巷	거리 항
亥	돼지 해
奚	어찌 해
該	갖출 해
享	누릴 향
軒	집 헌
弦	시위 현
絃	줄 현
縣	고을 현
穴	굴 혈
亨	형통할 형
螢	반딧불 형
兮	어조사 혜
乎	어조사 호
互	서로 호
毫	터럭 호
昏	어두울 혼
弘	클 홍
鴻	기러기 홍
禾	벼 화
擴	넓을 확
穫	거둘 확
丸	둥글 환
荒	거칠 황
曉	새벽 효
侯	재후 후
喉	목구멍 후
毁	헐 훼
輝	빛날 휘
携	이끌 휴
胸	가슴 흉
噫	한숨쉴 희
熙	빛날 희
2
葛	칡 갈
憾	섭섭할 감
坑	구덩이 갱
乞	빌 걸
揭	걸 게
隔	사이뜰 격
牽	이끌 견
繫	맬 계
雇	품팔 고
菓	과자 과
菓	실과 과
款	항목 관
狂	미칠 광
傀	허수아비 괴
僑	더부살이 교
絞	목멜 교
膠	아교 교
歐	구라파 구
購	살 구
掘	팔 굴
窟	굴 굴
圈	우리 권
闕	대궐 궐
軌	바퀴자국 궤
糾	얽힐 규
棋	바둑 기
尿	오줌 뇨
尼	여승 니
溺	빠질 닉
鍛	쇠불릴 단
膽	쓸개 담
垈	집터 대
戴	일 대
塗	칠할 도
悼	슬퍼할 도
棟	마룻대 동
屯	진칠 둔
藤	등나무 등
謄	베낄 등
騰	오를 등
裸	벗을 라
拉	끌 랍
輛	수레 량
煉	달굴 련
獵	사냥 렵
籠	대바구니 롱
僚	동료 료
療	병고칠 료
硫	유황 류
謬	그르칠 류
摩	문지를 마
痲	저릴 마
魔	마귀 마
膜	막 막
娩	낳을 만
灣	물굽이 만
網	그물 망
枚	낱 매
魅	매혹할 매
蔑	업신여길 멸
侮	업신여길 모
帽	모자 모
紊	문란할 문
舶	배 박
伴	짝 반
搬	운반할 반
紡	길쌈 방
俳	배우 배
賠	물어줄 배
閥	문벌 벌
僻	궁핍할 벽
倂	아우를 병
覆	덮을 복
覆	덮을 부
俸	녹 봉
縫	꿰맬 봉
敷	펼 부
匪	비적 비
唆	부추길 사
赦	용서할 사
飼	기를 사
傘	우산 산
蔘	삼 삼
揷	꽂을 삽
箱	상자 상
瑞	상서 서
誓	맹세할 서
碩	클 석
繕	기울 선
纖	가늘 섬
攝	다스릴 섭
貰	세놓을 세
紹	이을 소
垂	드리울 수
搜	찾을 수
屍	주검 시
殖	불릴 식
紳	띠 신
腎	콩팥 신
握	쥘 악
癌	암 암
押	누를 압
碍	거리낄 애
惹	이끌 야
躍	뛸 약
孃	아가씨 양
閱	볼 열
厭	싫어할 염
預	맡길 예
穩	편안할 온
擁	낄 옹
歪	기울 왜
妖	요사할 요
傭	품팔 용
熔	녹을 용
鬱	답답할 울
苑	나라동산 원
尉	벼슬 위
融	녹을 융
凝	엉길 응
妊	아이밸 임
磁	자석 자
諮	물을 자
宰	재상 재
沮	막을 저
殿	전각 전
竊	훔칠 절
偵	염탐할 정
呈	드릴 정
艇	큰배 정
劑	약제 제
彫	새길 조
措	둘 조
釣	낚시 조
綜	모을 종
奏	아뢸 주
珠	구슬 주
鑄	쇠불릴 주
駐	머무를 주
准	비준 준
旨	뜻 지
脂	기름 지
塵	티끌 진
津	나루 진
診	진찰할 진
震	우레 진
窒	막힐 질
輯	모을 집
遮	가릴 차
餐	밥 찬
刹	절 찰
札	편지 찰
斬	벨 참
彰	드러날 창
隻	외짝 척
撤	거둘 철
諜	염탐할 첩
滯	막힐 체
締	맺을 체
逮	잡을 체
遞	갈릴 체
哨	망볼 초
焦	탈 초
秒	분초 초
趨	달아날 추
蹴	찰 축
軸	굴대 축
衷	속마음 충
炊	불땔 취
託	부탁할 탁
誕	낳을 탄
胎	아이밸 태
颱	태풍 태
把	잡을 파
覇	으뜸 패
偏	치우칠 편
坪	들 평
怖	두려할 포
抛	던질 포
鋪	가게 포
虐	모질 학
翰	편지 한
艦	큰배 함
嫌	싫어할 혐
峽	골짜기 협
型	모형 형
衡	저울대 형
濠	호주 호
酷	심할 혹
靴	신 화
幻	헛보일 환
滑	미끄러울 활
滑	익살스러울 골
廻	돌 회
勳	공 훈
姬	계집 희
伽	절 가
柯	가지 가
賈	성 가
賈	장사 고
軻	사람이름 가
迦	부처이름 가
珏	쌍옥 각
杆	몽둥이 간
艮	괘이름 간
鞨	오랑캐이름 갈
邯	사람이름 감
邯	조나라서울 한
岬	곶 갑
鉀	갑옷 갑
姜	성 강
岡	산등성이 강
崗	언덕 강
彊	굳셀 강
疆	지경 강
价	클 개
塏	높은 땅 개
鍵	열쇄 건
杰	뛰어날 걸
桀	하왕이른 걸
甄	질그릇 견
儆	경계할 경
炅	빛날 경
璟	옥빛 경
瓊	구슬 경
皐	언덕 고
串	땅이름 곶
串	꽬 관
琯	옥피리 관
槐	회화나무 괴
玖	옥돌 구
邱	언덕 구
鞠	기를 국
圭	쌍토 규
奎	별 규
揆	헤아릴 규
珪	홀 규
槿	무궁화 근
瑾	아름다운 옥 근
兢	떨릴 긍
冀	바랄 기
岐	갈림길 기
沂	물이름 기
淇	물이름 기
琦	옥이름 기
琪	아름다운 옥 기
璣	별이름 기
箕	키 기
耆	늙을 기
騏	준마 기
驥	천리마 기
麒	기린 기
湍	여울 단
塘	못 당
悳	큰 덕
燾	비칠 도
惇	도타울 돈
燉	불빛 돈
頓	조아릴 돈
乭	이름 돌
董	바를 동
杜	막을 두
鄧	나라이름 등
萊	명아주 래
亮	밝을 량
樑	들보 량
呂	법칙 려
廬	농막집 려
礪	숫돌 려
驪	검은말 려
漣	잔물결 련
濂	물이름 렴
玲	옥소리 령
醴	단술 례
盧	성 로
蘆	갈대 로
魯	노나라 로
鷺	백로 로
遼	멀 료
劉	죽일 류
崙	산이름 륜
楞	네모질 릉
麟	기린 린
靺	말갈 말
貊	맥국 맥
覓	찾을 멱
冕	면류관 면
沔	물이름 면
俛	힘쓸 면
牟	성 모
茅	띠 모
謨	꾀 모
穆	화목할 목
昴	별이름 묘
汶	물이름 문
彌	미륵 미
旻	하늘 민
旼	화할 민
玟	아름다운 돌 민
珉	옥돌 민
閔	성 민
潘	성 반
磻	반계 반
渤	바다이름 발
鉢	바리때 발
旁	곁 방
龐	높은집 방
裵	성 배
筏	뗏목 벌
范	성 범
卞	성 변
弁	고깔 변
昞	밝을 병
昺	밝을 병
柄	자루 병
炳	불꽃 병
秉	잡을 병
潽	물이름 보
甫	클 보
輔	도울 보
馥	향기 복
蓬	쑥 봉
傅	스승 부
釜	가마 부
阜	언덕 부
芬	향기 분
鵬	새 붕
丕	클 비
毖	삼갈 비
毘	도울 비
彬	빛날 빈
泗	물이름 사
庠	학교 상
舒	펼 서
奭	쌍백 석
晳	밝을 석
錫	주석 석
瑄	도리옥 선
璇	옥 선
璿	구슬 선
卨	사람이름 설
薛	성 설
暹	나라이름 섬
蟾	두꺼비 섬
陝	땅이름 섬
燮	불꽃 섭
晟	밝을 성
巢	새집 소
沼	못 소
邵	성 소
宋	성 송
洙	물가 수
銖	저울눈 수
隋	수나라 수
洵	참으로 순
淳	순박할 순
珣	옥이름 순
舜	순임금 순
荀	풀이름 순
瑟	큰거문고 슬
繩	노끈 승
柴	섶 시
湜	물맑을 식
軾	수레가로나무 식
瀋	즙낼 심
閼	막을 알
鴨	오리 압
埃	티끌 애
艾	쑥 애
倻	가야 야
襄	도울 양
彦	선비 언
姸	고울 연
淵	못 연
衍	넓을 연
閻	마을 염
燁	빛날 엽
暎	비칠 영
瑛	옥빛 영
瑩	옥돌 영
瑩	밝을 형
盈	찰 영
濊	종족이름 예
睿	슬기 예
芮	성 예
吳	성 오
墺	물가 오
沃	기름질 옥
鈺	보배 옥
甕	독 옹
邕	막힐 옹
雍	화할 옹
莞	빙그레할 완
莞	왕골 관
旺	왕성할 왕
汪	넓을 왕
倭	왜나라 왜
堯	요임금 요
姚	예쁠 요
耀	빛날 요
溶	녹을 용
瑢	패옥소리 용
鎔	쇠녹일 용
鏞	쇠북 용
佑	도울 우
祐	복 우
禹	성 우
旭	아침해 욱
昱	햇빛밝을 욱
煜	빛날 욱
郁	성할 욱
頊	삼갈 욱
芸	향풀 운
蔚	고을이름 울
熊	곰 웅
媛	계집 원
瑗	구슬 원
袁	성 원
渭	물이름 위
韋	가죽 위
魏	성 위
兪	대답할 유
庾	곳집 유
楡	느릅나무 유
踰	넘을 유
允	맏 윤
尹	성 윤
胤	자손 윤
鈗	총 윤
垠	지경 은
殷	은나라 은
誾	향기 은
鷹	매 응
伊	저 이
怡	기쁠 이
珥	귀고리 이
翊	도울 익
佾	줄춤 일
鎰	무게이름 일
滋	불을 자
庄	전장 장
樟	녹나무 장
璋	홀 장
蔣	성 장
甸	경기 전
旌	기 정
晶	맑을 정
楨	광나무 정
汀	물가 정
珽	옥이름 정
禎	상서로울 정
鄭	나라 정
鼎	솥 정
曺	성 조
祚	복 조
趙	나라 조
琮	옥홀 종
疇	이랑 주
埈	높을 준
峻	높을/준엄할 준
晙	밝을 준
浚	깊게할 준
濬	깊을 준
駿	준마 준
址	터 지
芝	지초 지
稙	피 직
稷	올벼 직
晋	진나라 진
秦	성 진
燦	빛날 찬
璨	옥빛 찬
瓚	옥잔 찬
鑽	뚫을 찬
敞	시원할 창
昶	해길 창
埰	사패지 채
蔡	성 채
采	풍채 채
陟	오를 척
釧	팔찌 천
喆	밝을 철
澈	맑을 철
瞻	볼 첨
楚	초나라 초
蜀	나라이름 촉
崔	높을 최
楸	가래 추
鄒	추나라 추
椿	참죽나무 춘
冲	화할 충
聚	모을 취
峙	언덕 치
雉	꿩 치
灘	여울 탄
耽	즐길 탐
兌	바꿀 태
兌	기쁠 열
台	별 태
坡	언덕 파
阪	언덕 판
彭	성 팽
扁	작을 편
葡	포도 포
鮑	절인물고기 포
杓	북두자루 표
馮	탈 빙
馮	성 풍
弼	도울 필
泌	스며흐를 필
泌	분비할 비
陜	땅이름 합
陜	좁을 협
亢	높을 항
沆	넓을 항
杏	살구 행
爀	불빛 혁
赫	빛날 혁
峴	고개 현
炫	밝을 현
鉉	솥귀 현
瀅	물맑을 형
炯	빛날 형
邢	성 형
馨	꽃다울 형
壕	해자 호
扈	따를 호
昊	하늘 호
晧	밝을 호
澔	넓을 호
皓	흴 호
祜	복 호
鎬	호경 호
泓	물깊을 홍
嬅	탐스러울 화
樺	자작나무 화
桓	굳셀 환
煥	빛날 환
晃	밝을 황
滉	깊을 황
檜	전나무 회
淮	물이름 회
后	임금/왕후 후
壎	질나팔 훈
熏	불길 훈
薰	향풀 훈
徽	아름다울 휘
烋	아름다울 휴
匈	오랑캐 흉
欽	공경할 흠
嬉	아름다울 희
憙	기쁘할 희
熹	빛날 희
禧	복 희
羲	복희 희
1
呵	꾸짖을 가
哥	소리 가
嘉	아름다울 가
嫁	시집갈 가
稼	농사 가
苛	가혹할 가
袈	가사 가
駕	멍에 가
恪	삼갈 각
殼	껍질 각
墾	개간할 간
奸	간사할 간
揀	가릴 간
澗	산골물 간
癎	간질 간
竿	장대/낚시대 간
艱	어려울 간
諫	간할 간
喝	꾸짖을 갈
竭	다할 갈
褐	갈색/굵은베 갈
勘	헤아릴 감
堪	견딜 감
柑	귤 감
疳	감질 감
瞰	굽어볼 감
紺	감색/연보라 감
匣	갑 갑
閘	수문 갑
慷	슬플 강
糠	겨 강
腔	속빌 강
薑 	생강 강
凱	개선할 개
愾	성낼 개
漑	물댈 개
箇	낱 개
芥	겨자 개
羹	국 갱
醵	추렴할 거/갹
倨	거만할 거
渠	개천 거
巾	수건 건
腱	힘줄 건
虔	공경할 건
劫	겁줄 겁
怯	겁낼 겁
偈	중의귀글 게
檄	격문 격
膈	가슴 격
覡	박수 격
繭	고치 견
譴	꾸짖을 견
鵑	두견새 견
勁	굳셀 경
憬	깨달을 경
梗	줄기/막힐 경
痙	경련 경
磬	경쇠 경
脛	정강이 경
莖	줄기 경
頸	목 경
鯨	고래 경
悸	두근거릴 계
叩	두드릴 고
呱	울 고
拷	칠 고
敲	두드릴 고
痼	고질 고
股	넓적다리 고
膏	기름 고
袴	바지 고
辜	허물 고
錮	막을 고
梏	수갑 곡
鵠	고니 곡
昆	맏/벌레 곤
棍	몽둥이 곤
袞	곤룡포 곤
汨	골몰할 골
拱	팔짱낄 공
鞏	굳을 공
顆	낟알 과
廓	둘레 곽/ 클 확
槨	외관 곽
藿	콩잎/미역 곽
棺	널 관
灌	물댈 관
顴	광대뼈 관/권
刮	긁을 괄
括	묶을 괄
匡	바를 광
壙	뫼구덩이 광
曠	빌/넓을 광
胱	오줌통 광
卦	점괘 괘
罫	줄 괘
乖	어그러질 괴
拐	후릴 괴
魁	우두머리 괴
宏	클 굉
肱	팔뚝 굉
轟	울릴/수레소리 굉
咬	물/새소리 교
喬	높을 교
嬌	아리따울 교
攪	흔들 교
狡	교활할 교
皎	달 밝을 교
蛟	교룡 교
轎	가마 교
驕	교만할 교
仇	원수 구
嘔	게울 구
垢	때 구
寇	도적 구
嶇	험할 구
廐	마구간 구
枸	구기자 구
柩	널 구
毆	때릴 구
溝	도랑 구
灸	뜸 구
矩	법/모날 구
臼	절구 구
舅	시아비/외삼촌 구
衢	네거리 구
謳	노래/소리 구
軀	몸 구
鉤	갈고리 구
駒	망아지 구
鳩	비둘기 구
窘	군색할 군
穹	하늘 궁
躬	몸 궁
倦	게으를 권
捲	걷을/말 권
眷	돌볼 권
蹶	일어설/넘어질 궐
机	책상 궤
櫃	궤짝 궤
潰	무너질 궤
詭	속일 궤
几	안석 궤
硅	규소 규
窺	엿볼 규
葵	아욱/해바리기 규
逵	길거리 규
橘	귤 귤
剋	이길 극
戟	창 극
棘	가시 극
隙	틈 극
覲	뵐 근
饉	주릴 근
擒	사로잡을 금
衾	이불 금
襟	옷깃 금
扱	미칠 급/꽂을 삽
汲	물길을 급
亘	뻗칠 긍/베풀선
亘	베풀선
矜	자랑할 긍
伎	재간 기
嗜	즐길 기
妓	기생 기
崎	험할 기
朞	돌 기
杞	구기자 기
畸	뙈기밭 기
綺	비단 기
羈	굴레/나그네 기
肌	살 기
譏	비웃을 기
拮	일할 길
喫	마실 끽
儺	푸닥거리 나
懦	나약할 나
懶	게으를 라
拏	잡을 나/라
拿	잡을 나
螺	소라 라
煖	더울 난
捏	꾸밀 날
捺	누를 날
衲	기울 납
囊	주머니 낭
撚	비빌 년
弩	쇠뇌 노
駑	둔한말 노
膿	고름 농
磊	돌무더기 뢰
訥	말더듬을 눌
紐	맺을 뉴
匿	숨길 닉
簞	소쿠리 단
緞	비단 단
蛋	새알 단
撻	때릴 달
疸	황달 달
憺	참담할 담
曇	흐릴 담
澹	맑을 담
痰	가래 담
譚	클/속담 담
遝	뒤섞일 답
撞	칠 당
棠	아가위 당
螳	사마귀 당
擡	들 대
袋	자루 대
堵	담 도
屠	죽일 도
掉	흔들 도
搗	찧을 도
淘	쌀 일 도
滔	물넘칠 도
濤	물결 도
睹	볼 도
禱	빌 도
萄	포도 도
賭	내기 도
蹈	밟을 도
鍍	도금할 도
瀆	도랑/더럽힐 독
禿	대머리 독
沌	엉길 돈
憧	동경할 동
疼	아플 동
瞳	눈동자 동
胴	큰창자/몸통 동
兜	투구 두/도솔천 도
痘	마마 두
臀	볼기 둔
遁	숨을 둔
橙	귤/걸상 등
癩	문둥이 라/나
邏	순라 라
烙	지질 락
酪	쇠젖 락
駱	낙타 락
瀾	물결 란
鸞	난새 란
剌	발랄할 랄/수라 라
辣	매울 랄
籃	대바구니 람
臘	섣달 랍
蠟	밀 랍
狼	이리 랑
倆	재주 량
粱	기장 량
侶	짝 려
戾	어그러질 려
濾	거를 려
閭	마을 려
黎	검을 려
瀝	스밀 력
礫	조약돌 력
輦	가마 련
斂	거둘 렴
殮	염할 렴
簾	발 렴
囹	옥 령
逞	쾌할 령
鈴	방울 령
齡	나이 령
撈	건질 로
擄	노략질할 로
虜	사로잡을 로
碌	푸른 돌 록
麓	산기슭 록
壟	밭두둑 롱
瓏	옥소리 롱
聾	귀머거리 롱
儡	꼭두각시 뢰
牢	우리 뢰
賂	뇌물 뢰
寮	동관 료
燎	횃불 료
瞭	밝을 료
聊	에오라지 료
壘	보루 루
陋	더러울 루
溜	처마물 류
琉	유리 류
瘤	혹 류
戮	죽일 륙
淪	빠질 륜
綸	벼리 륜
慄	떨릴 률
勒	굴레 륵
肋	갈빗대 륵
凜	찰 름
凌	업신여길 릉
稜	모날 릉
綾	비단 릉
菱	마름 릉
俚	속될 리
厘	다스릴 리
悧	영리할 리
痢	이질 리
籬	울타리 리
罹	걸릴 리
裡	속 리
吝	아낄 린
燐	도깨비불 린
躪	짓밟을 린
鱗	비늘 린
淋	임질 림
笠	삿갓 립
粒	낟알 립
寞	고요할 막
卍	만자 만
彎	굽을 만
挽	당길 만
瞞	속일 만
蔓	덩굴 만
輓	끌/애도할 만
饅	만두 만
鰻	뱀장어 만
抹	지울 말
沫	물거품 말
襪	버선 말
芒	까끄라기 망
惘	멍할 망
寐	잠잘 매
昧	어두울 매
煤	그을음 매
罵	꾸짖을 매
邁	갈 매
呆	어리석을 매
萌	싹 맹
棉	목화 면
眄	곁눈질할 면
緬	멀 면
麵	국수 면
暝	저물 명
溟	바다 명
皿	그릇 명
螟	멸구 명
酩	술취할 명
袂	소매 몌
摸	본뜰 모
牡	숫컷 모
耗	소모할 모
糢	모호할 모
歿	죽을 몰
描	그릴 묘
杳	어두울 묘
渺	아득할 묘
猫	고양이 묘
巫	무당 무
憮	어루만질 무
拇	엄지손가락 무
撫	어루만질 무
毋	말 무
畝	이랑 무/묘
蕪	거칠 무
誣	속일 무
紋	무늬 문
蚊	모기 문
媚	아첨할 미
薇	장미 미
靡	쓰러질 미
悶	답답할 민
謐	고요할 밀
剝	벗길 박
搏	두드릴 박
撲	칠 박
樸	순박할 박
珀	호박 박
箔	발 박
粕	지게미 박
縛	얽을 박
膊	어깨 박
駁	논박할 박
拌	버릴 반
攀	더위잡을 반
斑	아롱질 반
槃	쟁반 반
畔	밭두둑 반
礬	백반 반
絆	얽어맬 반
蟠	서릴 반
頒	나눌 반
勃	노할 발
撥	다스릴 발
潑	물뿌릴 발
跋	밟을 발
醱	술 괼 발
魃	가물 발
坊	동네 방
尨	클/삽살개 방
幇	도울 방
彷	헤맬 방
昉	밝을 방
枋	다목 방
榜	방붙일 방
肪	기름 방
膀	오줌통 방
謗	헐뜯을 방
徘	어정거릴 배
湃	물결칠 배
胚	아이밸 배
陪	모실 배
帛	비단 백
魄	넋 백
蕃	무성할 번
藩	울타리 번
帆	돛 범
梵	불경 범
氾	넘칠 범
泛	뜰 범
劈	쪼갤 벽
擘	엄지손가락 벽
璧	구슬 벽
癖	버릇 벽
闢	열 벽
瞥	눈깜짝할 별
鱉	자라 별
甁	병 병
餠	떡 병
堡	작은성 보
洑	보 보/스며흐를 복
菩	보살 보
僕	종 복
匐	길 복
輻	바퀴살 복/폭
鰒	전복 복
捧	받들 봉
棒	막대
烽	봉화 봉
鋒	칼날 봉
俯	구부릴 부
剖	쪼갤 부
咐	분부할 부
埠	부두 부
孵	알깔 부
斧	도끼 부
腑	육부 부
芙	연꽃 부
訃	부고 부
賻	부의 부
駙	부마 부
吩	분부할 분
噴	뿜을 분
忿	성낼 분
扮	꾸밀 분
焚	불사를 분
盆	동이 분
糞	똥 분
雰	눈 날릴 분
彿	비슷할 불
棚	사다리 붕
硼	붕사 붕
繃	묶을 붕
匕	비수 비
庇	덮을 비
憊	고달플 비
扉	사립문 비
沸	끊을 비/용솟음할 불
琵	비파 비
痺	저릴 비
砒	비상 비
秕	쭉정이 비
緋	비단 비
翡	물총새 비
脾	지라 비
臂	팔 비
蜚	날/바퀴 비
裨	도울 비
誹	헐뜯을 비
譬	비유할 비
鄙	더러울 비
妣	죽은어미 비
嚬	찡그릴 빈
嬪	궁녀벼슬이름 빈
殯	빈소 빈
濱	물가 빈
瀕	물가 빈
瀕	가까울 빈
憑	기댈 빙
些	적을 사
嗣	이을 사
奢	사치 사
娑	춤출/사바세상 사
徙	옮길 사
瀉	쏟을 사
獅	사자 사
祠	사당 사
紗	비단 사
蓑	도롱이 사
麝	사향노루 사
刪	깍을 산
珊	산호 산
疝	산증 산
撒	뿌릴 살
煞	죽일 살
薩	보살 살
渗	스며들 삼
澁	떫을 삽
孀	홀어미 상
爽	시원할 상
翔	날 상
觴	잔 상
璽	옥새 새
嗇	아낄 색
牲	희생 생
甥	생질 생
嶼	섬 서
抒	펼 서
曙	새벽 서
棲	깃들일 서
犀	무소 서
胥	서로 서
薯	감자 서
逝	갈 서
黍	기장 서
鼠	쥐 서
婿	사위 서
潟	개펄 석
扇	부채 선
煽	부채질할 선
羨	부러워할 선
腺	샘 선
膳	선물/반찬 선
銑	무쇠 선
屑	가루 설
泄	샐 설
洩	샐 설
渫	파낼 설
殲	몰살할 섬
閃	번쩍거릴 섬
醒	깰 성
塑	흙빚을 소
宵	밤 소
搔	긁을 소
梳	얼레빗 소
甦	깨어날 소
疏	성길 소
瘙	피부병 소
簫	퉁소 소
蕭	쓸쓸할 소
逍	노닐 소
遡	거스를 소
贖	속죄할 속
遜	겸손할 손
悚	두려워할 송
灑	물뿌릴 쇄
碎	부술 쇄
嫂	형수 수
戍	수자리 수
狩	사냥 수
瘦	여윌 수
穗	이삭 수
竪	세울 수
粹	순수할 수
繡	수놓을 수
羞	부끄러울 수
蒐	모을 수
袖	소매 수
讐	원수 수
酬	갚을 수
髓	골수 수
塾	글방 숙
夙	일찍 숙
菽	콩 숙
筍	죽순 순
醇	전국술 순
馴	길들일 순
膝	무릎 슬
丞	정승 승
匙	숟가락 시
媤	시집 시
弑	윗사람죽일 시
枾	감 시
猜	시기할 시
諡	시호 시
豺	승냥이 시
拭	씻을 식
熄	불꺼질 식
蝕	좀먹을 식
呻	읊조릴 신
娠	아이밸 신
宸	대궐 신
燼	불탄 끝 신
薪	섶 신
蜃	큰조개 신
訊	물을 신
迅	빠를 신
悉	다 실
什	열사람 십/세간 집
俄	아까 아
啞	벙어리 아
衙	마을 아
訝	의심할 아
堊	흰흙 악
愕	놀랄 악
顎	턱 악
按	누를 안
晏	늦을 안
鞍	안장 안
斡	돌 알
軋	삐걱거릴 알
庵	암자 암
闇	어두울 암
怏	원망할 앙
昻	오를 앙
秧	모 앙
鴦	원앙 앙
崖	언덕 애
曖	희미할 애
隘	좁을 애
靄	아지랑이 애
扼	누를 액
縊	목맬 액
腋	겨드랑이 액
櫻	앵두 앵
鶯	꾀꼬리 앵
冶	풀무 야
揶	야유할 야
爺	아비 야
葯	꽃밥 약
恙	병/금심할 양
攘	물리칠 양
瘍	헐 양
釀	술 빚을 양
癢	가려울 양
圄	옥 어
瘀	어혈질 어
禦	막을 어
臆	가슴 억
堰	둑 언
諺	속담/언문 언
俺	나 엄
儼	의젓할 엄
奄	문득 엄
繹	풀 역
捐	버릴 연
椽	서까래 연
筵	대자리 연
鳶	솔개 연
涅	개흙 열
焰	불꽃 염
艶	고울 염
嬰	어린아이 영
曳	끌 예
穢	더러울 예
裔	후손 예
詣	이를 예
伍	대오/다섯사람 오
奧	깊을 오
寤	잠깰 오
懊	한할 오
蘊	쌓을 온
壅	막을 옹
渦	소용돌이 와
蝸	달팽이 와
訛	그릇될 와
婉	순할/아름다울 완
宛	완연할 완
琓	즐길 완
腕	팔뚝 완
阮	성 완
頑	완고할 완
枉	굽을 왕
矮	난쟁이 왜
巍	높고클 외
猥	외람할 외
僥	요행 요
凹	오목할 요
夭	일찍죽을 요
寥	쓸쓸할 요
拗	우길 요
撓	휠 요
擾	시끄러울 요
窈	고요할 요
窯	가마 요
邀	맞을 요
饒	넉넉할 요
涌	물솟을 용
聳	솟을 용
茸	풀날 용/ 버섯 이
蓉	연꽃 용
踊	뛸 용
寓	부칠우
虞	염려할/나라이름 우
迂	에돌 우
隅	모퉁이 우
嵎	산굽이 우
殞	죽을 운
耘	김맬 운
隕	떨어질 운
寃	원통할 원
猿	원숭이 원
鴛	원앙 원
萎	시들 위
喩	깨우칠 유
宥	너그러울 유
愉	즐거울 유
揄	야유할 유
柚	유자 유
游	헤엄칠 유
癒	병나을 유
諛	아첨할 유
諭	타이를 유
蹂	밟을 유
鍮	놋쇠 유
戎	오랑캐/병장기 융
絨	가는베 융
蔭	그늘 음
揖	읍할 읍
膺	가슴 응
擬	비길 의
椅	의자 의
毅	굳셀 의
誼	정 의
姨	이모 이
弛	늦출 이
爾	너 이
痍	상처 이
餌	미끼 이
翌	다음날 익
咽	목구멍 인/목맬 열
湮	묻힐 인
蚓	지렁이 인
靭	질길 인
佚	편안할 일/질탕 질
溢	넘칠 일
剩	남을 잉
孕	아이밸 잉
仔	자세할 자
炙	구울 자/적
煮	삶을 자
瓷	사기그릇 자
疵	허물 자
蔗	사탕수수 자
藉	깔/핑계할 자
勺	구기 작
嚼	씹을 작
灼	불사를 작
炸	터질 작
綽	너그러울 작
芍	함박꽃 작
雀	참새 작
鵲	까치 작
棧	사다리 잔
盞	잔 잔
箴	경계 잠
簪	비녀 잠
仗	병장기 장
匠	장인 장
杖	지팡이 장
檣	돛대 장
漿	즙 장
獐	노루 장
薔	장미 장
醬	간장 장
滓	찌끼 재
齋	재계할 재
錚	쇳소리 쟁
咀	씹을 저
狙	원숭이/엿볼 저
猪	돼지 저
箸	젓가락 저
詛	저주할 저
躇	머뭇거릴 저
邸	집 저
觝	씨름 저
嫡	정실 적
狄	오랑캐 적
謫	귀양갈 적
迹	자취 적
剪	가위 전
塡	메울 전
奠	정할/제사 전
廛	가게 전
悛	고칠 전
栓	마게 전
氈	모전 전
澱	앙금 전
煎	달일 전
癲	미칠 전
箋	기록할 전
箭	화살 전
篆	전자 전
纏	얽을 전
輾	돌 전
銓	저울질할 전
顚	엎드릴/이마 전
顫	떨릴 전
餞	보낼 전
截	끊을 절
粘	붙을 점
霑	젖을 점
幀	그림족자 정
挺	빼어날 정
町	밭두둑 정
睛	눈동자 정
碇	닻 정
穽	함정 정
酊	술취할 정
釘	못 정
錠	덩이 정
靖	편안할 정
啼	울 제
悌	공손할 제
梯	사다리 제
蹄	굽 제
凋	시들 조
嘲	비웃을 조
曹	무리 조
棗	대추 조
槽	통 조
漕	배로실어나를 조
爪	손톱 조
眺	볼 조
稠	빽빽할 조
粗	거칠 조
糟	지게미 조
繰	고치켤 소
肇	시작할 조
藻	마름 조
詔	조서 조
躁	조급할 조
遭	만날 조
阻	막힐 조
簇	가는대 족
猝	갑자기 졸
慫	권할 종
腫	종기 종
踪	자취 종
踵	발꿈치 종
挫	꺽을 좌
做	지을 주
胄	자손 주
呪	빌 주
嗾	부추길 주
廚	부엌 주
紂	주임금 주
紬	명주 주
註	글뜻풀 주
誅	벨 주
躊	머뭇거릴 주
輳	몰려들 주
樽	술통 준
蠢	꾸물거릴 준
櫛	빗 즐
汁	즙 즙
葺	기울 즙
咫	여덟치 지
摯	잡을 지
枳	탱자 지
祉	복 지
肢	팔다리 지
嗔	성낼 진
疹	마마 진
叱	꾸짖을 질
嫉	미워할 질
帙	책갑 질
桎	차꼬 질
膣	음도 질
跌	거꾸러질 질
迭	갈마들 질
斟	짐작할 짐
朕	나 짐
澄	맑을 징
叉	갈래 차
嗟	탄식할 차
蹉	미끄러질 차
搾	짤 착
窄	좁을 착
鑿	뚫을 착
撰	지을 찬
簒	빼앗을 찬
纂	모을 찬
饌	반찬 찬
擦	문지를 찰
僭	참람할 참
塹	구덩이 참
懺	뉘우칠 참
站	역마을 참
讒	참소할 참
讖	예언 참
倡	광대 창
娼	창녀 창
廠	공장 창
愴	슬플 창
槍	창 창
漲	넘칠 창
猖	미쳐날뛸 창
瘡	부스럼 창
脹	부을 창
艙	부두 창
菖	창포 창
寨	목책 책
柵	울타리 책
凄	쓸쓸할 처
擲	던질 척
滌	씻을 척
瘠	여윌 척
脊	등마루 척
喘	숨찰 천
擅	멋대로할 천
穿	뚫을 천
闡	밝힐 천
凸	볼록할 철
綴	엮을 철
轍	바퀴자국 철
僉	다/여러 첨
籤	제비 첨
諂	아첨할 첨
帖	문서 첩
捷	빠를 첩
牒	편지 첩
疊	거듭 첩
貼	붙일 첩
涕	눈물 체
諦	살필 체
憔	파리할 초
梢	나무끝 초
樵	뗄나무 초
炒	볶을 초
硝	화약 초
礁	암초 초
稍	점점 초
蕉	파초 초
貂	담비 초
醋	초 초/잔돌릴 작
囑	부탁할 촉
忖	헤아릴 촌
叢	모일 총
塚	무덤 총
寵	사랑할 총
撮	모을/사진찍을 촬
墜	떨어질 추
椎	쇠뭉치/등골 추
樞	지도리 추
芻	꼴 추
酋	우두머리 추
錐	송곳 추
錘	저울추 추
鎚	쇠망치 추
鰍	미꾸라지 추
黜	내칠 출
悴	파리할 췌
膵	췌장 췌
萃	모을 췌
贅	혹 췌
娶	장가들 취
翠	푸를 취
翠	물총새 취
脆	연할 취
惻	슬퍼할 측
侈	사치할 치
嗤	비웃을 치
幟	기 치
熾	성할 치
痔	치질 치
痴	어리석을 치
緻	빽빽할 치
馳	달릴 치
勅	칙서 칙
砧	다듬잇돌 침
鍼	침 침
蟄	숨을 칩
秤	지울 칭
唾	침 타
惰	게으를 타
楕	길고둥글 타
舵	키 타
陀	비탈질/부처 타
駝	낙타 타
擢	뽑을 탁
鐸	방울 탁
呑	삼킬 탄
坦	평평할 탄
憚	꺼릴 탄
綻	터질 탄
眈	노려볼 탐
搭	탈 탑
宕	호방할 탕
蕩	방탕할 탕
汰	일 태
笞	볼기칠 태
苔	이끼 태
跆	밟을 태
撑	버틸 탱
攄	펼 터
慟	원통할 통
桶	통 통
筒	대통 통
堆	쌓을 퇴
槌	칠 퇴/망치 추
腿	넓적다리 퇴
褪	바랠 퇴
頹	무너질 퇴
套	씌울 투
妬	샘낼 투
慝	사특할 특
婆	할미/사바 파
巴	꼬리 파
爬	끍을 파
琶	비파 파
芭	파초 파
跛	절름발이 파
跛	비스듬이설 피
辦	힘쓸 판
佩	찰 패
唄	염불소리 패
悖	거스를 패
沛	비 쏟아질 패
牌	패 패
稗	피 패
澎	물소리 팽
膨	불을 팽
愎	강퍅할 퍅
鞭	채찍 편
騙	속일 편
貶	낮출 폄
萍	부평초 평
斃	죽을 폐
陛	대궐섬돌 폐
匍	길 포
咆	고함지를 포
哺	먹일 포
圃	채마밭 포
泡	거품 포
疱	물집 포
脯	포 포
蒲	부들 포
袍	도포 포
褒	기릴 포
逋	도망갈 포
庖	부엌 포
曝	쪼일 폭/포
瀑	폭포 폭/소나기 포
剽	겁박할 표
慓	급할 표
豹	표범 표
飄	나부낄 표
稟	여쭐 품
諷	풍자할 풍
披	헤칠 피
疋	필 필
乏	모자를 핍
逼	핍박할 핍
瑕	허물 하
蝦	두꺼비 하
蝦	새우 하
遐	멀 하
霞	노을 하
壑	구렁 학
謔	희롱할 학
瘧	학질 학
悍	사나울 한
澣	빨래할 한
澣	열흘 한
罕	드물 한
轄	다스릴 할
喊	고함칠 함
檻	난간 함
檻	우리 함
函	함 함
涵	젖을 함
緘	봉할 함
銜	재갈 함
鹹	짤 함
盒	합 합
蛤	조개 합
缸	항아리 항
肛	항문 항
偕	함께 해
咳	기침 해
懈	게으를 해
楷	본보기 해
諧	화할 해
邂	우연히만날 해
駭	놀랄 해
骸	뼈 해
劾	꾸짖을 혁
嚮	길잡을 향
饗	잔치할 향
噓	불 허
墟	터 허
歇	쉴 헐
眩	어지러울 현
絢	무늬 현
衒	자랑할 현
俠	의기로울 협
挾	낄 협
狹	좁을 협
頰	뺨 협
荊	가시 형
彗	비/살별 혜
醯	식혜 혜
弧	활 호
狐	여우 호
琥	호박 호
瑚	산호 호
糊	풀칠할 호
渾	흐릴 혼
惚	황홀할 홀
笏	홀 홀
哄	떠들석할 홍
虹	무지개 홍
訌	어지러울 홍
喚	부를 환
宦	벼슬/내시 환
驩	기뻐할 환
鰥	홀아비 환
猾	교활할 활
闊	넓을 활
凰	봉황 황
徨	헤맬 황
恍	황홀할 황
惶	두려울 황
慌	어리둥절할 황
煌	빛날 황
遑	급할 황
徊	머뭇거릴 회
恢	넓을 회
晦	그믐 회
繪	그림 회
膾	회 회
蛔	회충 회
誨	가르칠 회
賄	뇌물/재물 회
哮	성낼 효
嚆	울릴 효
爻	사귈/가로그을 효
酵	삭힐 효
吼	울부짖을 후
嗅	맡을 후
朽	썩을 후
逅	만날 후
暈	무리 훈
喧	지껄일 훤
卉	풀 훼
喙	부리 훼
彙	무리 휘
諱	삼갈/꺼릴 휘
麾	기 휘
恤	불쌍할 휼
兇	흉악할 흉
洶	용솟음칠 흉
欣	기쁠 흔
痕	흔적 흔
欠	하품 흠
歆	흠향할 흠
恰	흡사할 흡
洽	젖을 흡
犧	희생 희
詰	꾸짖을 힐